111111111111111111111
1001000000000000000C1
100000000000011111111
1P0011E000000000000C1
111111111111111111111
