             1             
            111            
           10001           
          1000001          
         100000001         
        10001110001        
       1001 1  1001       
      1001  P   1001      
     1001  111   1001     
    1001  1 E 1   1001    
   1001   11111   1001   
  1001  C       C  1001  
 1001111000000001111001 
101000000000000000000101 
1111111111111111111111111  