1111111111
10000C0001
1P000000E0
1111111111
